acrasial	adj	
addecimate	v	
adimpleate	v	
adnascentia	npl	
aeipathy	n	
affictitious	adj	
affuage	n	
agonarch	n	
agonyclite	n	
airgonaut	n	
alabandical	adj	
albedineity	n	
alogotrophy	n	
amandation	n	
amarulence	n	
amorevolous	adj	
antipelargy	n	
apanthropinization	n	
aporrhoea	n	
aquabib	n	
archigrapher	n	
archiloquy	n	
aretaloger	n	
artigrapher	n	
ascoliasm	n	
assectation	n	
austerulous	adj	
autexousious	adj	
auturgy	n	
avunculize	v	
bajulate	v	
bimarian	adj	
binoternary	adj	
blateration	n	
bonifate	adj	
boreism	n	
boscaresque	adj	
brabeum	n	
brephophagist	n	
brochity	n	
bromography	n	
bubulcitate	v	
buccellation	n	
bumposopher	n	
cacatory	adj	
cacozealous	adj	
cagastric	adj	
cameranious	adj	
canitude	n	
caprizant	adj	
casitive	adj	
castaldy	n	
cecograph	n	
celeberrimous	adj	
celeripedean	adj	
cestuan	adj	
chermadic	adj	
chronanagram	n	
cibosity	n	
circuland	n	
circumbilivagination	n	
citharize	v	
cloakatively	adv	
coherentific	adj	
colaphize	v	
commendaces	npl	
coquinate	v	
cosmogyral	adj	
crassulent	adj	
crebrity	n	
crocitation	n	
cynicocratical	adj	
deartuate	v	
decutient	adj	
defedate	v	
desarcinate	v	
devalgate	adj	
dicaearchy	n	
diffibulate	v	
dignorate	v	
diloricate	v	
dipsopathy	n	
diribitory	n	
divinipotent	adj	
dodrantal	adj	
drollic	adj	
dromograph	n	
ducenarious	adj	
ebaptization	n	
ecstasiate	v	
ectylotic	adj	
egrote	v	
eicastic	adj	
ejurate	v	
embaphium	n	
embolimaeal	adj	
epalpebrate	adj	
ephydriad	n	
essomenic	adj	
eternitarian	n	
eveniency	n	
excutient	adj	
exipotic	adj	
exlineal	adj	
fabrefaction	n	
fallaciloquence	n	
famelicose	adj	
famigerate	v	
ficulnean	adj	
filicology	n	
findible	adj	
flosculation	n	
foppotee	n	
frenigerent	adj	
fumificate	v	
gardeviance	n	
gardevisure	n	
gaudiloquent	adj	
gelicide	n	
gipseian	adj	
gleimous	adj	
gnathonize	v	
graocracy	n	
graviloquence	n	
gumfiate	v	
gutturniform	adj	
gypsation	n	
habroneme	adj	
halatinous	adj	
hecatologue	n	
hemerine	adj	
hercotectonic	adj	
hirculation	n	
hirquitalliency	n	
historiaster	n	
hiulcity	n	
homerkin	n	
hymnicide	n	
hyometer	n	
hypenemious	n	
icasm	n	
ichorescent	adj	
ichthyarchy	n	
ictuate	v	
igniparous	adj	
impigrity	n	
improcerous	adj	
incabinate	v	
ingeniculation	n	
ingordigious	adj	
inocciduous	adj	
inobligality	n	
interfation	n	
inveteratist	n	
ipsographic	adj	
irredivivous	adj	
isangelous	adj	
jecorary	adj	
jobler	n	
jumperism	n	
jungible	adj	
jussulent	adj	
kalotypography	n	
keleusmatically	adv	
kexy	adj	
krioboly	n	
labascate	v	
lagenarious	adj	
lambition	n	
lampistry	n	
lardlet	n	
latibule	n	
leeftail	adj	
legatarian	adj	
leporicide	n	
lignatile	adj	
lignicide	n	
lococession	n	
locupletative	adj	
logarithmotechny	n	
lubency	n	
lugent	adj	
lutherolatry	n
macellarious	adj	
magastromancy	n	
magistricide	n	
magophony	n	
maleolent	adj	
mancation	n	
mariturient	adj	
mecography	n	
medioxumate	adj	
melanochalcographer	n	
miliaceous	adj	
mingent	adj	
misqueme	v	
mitescent	adj	
mochlic	n	
modernicide	n	
molrowing	n	
montivagant	adj	
morsicant	adj	
mowburnt	adj	
mulcible	adj	
mulomedic	adj	
murklins	adv	
myriander	adj	
namelings	npl	
nepheliad	n	
nequient	adj	
nerterology	n	
nidifice	n	
noscible	adj	
novaturient	adj	
nubivagant	adj	
obacerate	v	
obarmate	v	
obrumpent	adj	
obstrigillate	v	
occaecation	n	
occulcation	n	
odynometer	n	
omniregency	n	
oncethmus	n	
operiment	n	
oporopolist	n	
orgiophant	n	
ossifragant	adj	
ovablastic	adj	
palintocy	n	
palmoscopy	n	
pamphagous	adj	
panchymagogue	n	
pannuscorium	n	
papicolist	n	
parepochism	n	
paterophobia	n	
patration	n	
pecuarious	adj	
pedegorize	v	
penarious	adj	
penintime	adj	
perantique	adj	
pessundate	v	
phalerate	adj	
phasianic	adj	
philargyrist	n	
phlyarologist	n	
phoenigm	n	
phylactology	n	
pication	n	
pigritude	n	
piladex	n	
pilimiction	n	
plebicolar	adj	
plegnic	adj	
plenisphere	n	
pocilliform	adj	
poliadic	adj	
pomarious	adj	
ponask	v	
portmantologist	n	
prandicle	n	
prebition	n	
pregnatress	n	
prescited	adj	
primifluous	adj	
privign	n	
psalloid	adj	
psephograph	n	
pseudisodomous	adj	
ptochology	n	
pudify	v	
pugnastics	n	
pullarian	adj	
pyroleter	n	
quadragintireme	n	
quadrimular	adj	
quaeritate	v	
quercivorous	adj	
quibbleism	n	
quotientive	adj	
radicarian	adj	
ramifactive	adj	
recineration	n	
redamancy	n	
rendling	n	
resarciate	v	
rhedarious	adj	
rhodologist	n	
rimestock	n	
riviation	n	
roblet	v	
rogalian	adj	
rogitate	v	
roomthily	adj	
rupography	n	
ruricolous	adj	
saburrate	v	
sacricolist	n	
sagittiferous	adj	
sagittipotent	adj	
sarcinarious	adj	
scaevity	n	
scandiscope	n	
scathefire	n	
scelidate	adj	
sceptriferous	adj	
schismarch	n	
secability	n	
sedecuple	n	
sementine	adj	
senticous	adj	
seplasiary	n	
sermonolatry	n	
sevidical	adj	
sevous	adj	
siagonology	n	
sigilism	n	
sinapistic	adj	
sireniform	adj	
slimikin	adj	
snobographer	n	
sodalitious	adj	
soleated	adj	
solennial	adj	
soloecal	adj	
somandric	adj	
sophronize	v	
sospital	adj	
sparsile	adj	
speustic	adj	
spiscious	adj	
sputcheon	n	
squiriferous	adj	
stagma	n	
starrify	v	
stibogram	n	
stigmatypy	n	
stiricide	n	
sturionic	adj	
succisive	adj	
suffarcinate	v	
summotion	n	
supellectile	adj	
surgation	n	
synallactic	adj	
tabernarious	adj	
tantuple	adj	
tauroboly	n	
tecnolatry	n	
teliferous	adj	
telligraph	n	
temerate	v	
tenellous	adj	
tetanothrum	n	
teterrimous	adj	
theomeny	n	
thural	adj	
thysiastery	n	
tolfraedic	adj	
tornatil	adj	
tortiloquy	n	
trabeal	adj	
traboccant	adj	
tragematopolist	n	
trajectitious	adj	
tremefy	v	
triclavianism	n	
tristifical	adj	
tropaean	adj	
trophaeal	adj	
tudiculate	v	
tussicate	v	
uglyography	n	
ulvose	adj	
urette	n	
utible	adj	
utlegation	n	
uviferous	adj	
vacivity	n	
vadiation	n	
vadosity	n	
vampirarchy	n	
vanmost	adv	
vappous	adj	
vargeous	adj	
vectarious	adj	
vellicle	n	
venalitious	adj	
venialia	n	
venundate	v	
venustation	n	
veprecose	adj	
veteratorian	adj	
vicambulate	v	
viduifical	adj	
viliorate	v	
vinitorian	adj	
virtival	n	
visotactile	adj	
vocitate	v	
volgivagant	adj	
vultuous	adj	
weequashing	n	
welmish	adj	
woundikins	npl	
xenization	n	
yelve	n	
zygostatical	adj	
